XXXXXXXXXXXXXXXXXXXXXXXXXXX
XOXXXXGQQQQQQQQQQQQQGXXXXOX
XQQQQQQXXXTXXXXXTXXXQQQQQQX
XQQXXXTQQQQQQQQQQQQQTXXXQQX
XXQQQXXQXXXQQQQQXXXXQQQQQXX
XQQXXXQQQQQQXMXQQQQQQXXXQQX
XXQQQQQQXXXQQTQQXXXQQQQQQXX
XQQXXXTQQQQQQXQQQQQQTXXXXQX
XQQQQQXQXXXXXTXXXXXQQQQQQQX
XOXXXXGQQQQQQQQQQQQQGXXXXOX
XXXXXXXXXXXXXXXXXXXXXXXXXXX
