XXXXXXXXXXXXXXXXXXXXXXXXXXX
XMQQXXXXQQQQQQQQQQQXXXXQQQX
XQXQOQQQQXXXXXXXXXQQTQOQXQX
XQXXXXXXXXXQQQQQXXXXX XXXQX
XQQQGQQQQQTQXQXQTQQQQQGQQQX
XXXXXXXTXXX XXXQX XXXXXXXXX
XQQGQQQQ QTQXQXQTQQQQQQGQQX
XQXXXXXQXQX QQQQX XTXXXXXQX
XQOQQQXQXQXXXXXXXQXQ QQQOQX
XXQXXQXQQQQQQQQQQQXQXQXXQXX
XXXXXXXXXXXXXXXXXXXXXXXXXXX