XXXXXXXXXXXXXXXXXXXXXXXXXXX
XQQTQQQQQQQQQQQQQTQXGQQQQQX
XXQX XXXXQXXTQXXQX TQXXXQXX
XXGQQQQOQQQQX XQQXOX QQXQQX
XQQQXXXXXQQXQQQXXXQXXXQQXQX
XQXQQQXQQQQQQMQQQQQXQQQXXQX
XQQXXQXQXXQXQQQXXXQXXXQQTQX
XXQQXTXQQQQQXQXQQXQTGQQXXQX
XQXOQQ QXQXQXQXQQXQX XQQXQX
XQQQXXXQXQXGQQQQQQQQQQQQOQX
XXXXXXXXXXXXXXXXXXXXXXXXXXX